##############################
#A#       #       #     #     
# # # ##### ### ### # # # ### 
#   #     # # #     # # # #   
######### # # ####### # ### # 
#   # #   #         # #     # 
### # # ### ######### ####### 
#   #     #   #       # #   # 
# ### ##### ### ####### # # # 
# #   #   #   # # #   #   # # 
# # ### # ### # # # # # ### # 
# # #   #   # # #   #   # #   
# # ### ### ### ##### ### ####
#     #   #   #     #         
##### ### ### # ### ######### 
#   #   #   # #   # #   #     
# ##### ### # ##### ### # ####
#       #   #   #   #   #   # 
# ####### ##### # ### ##### # 
# # #     #   #   #   #   # # 
# # # ##### ####### ### # # # 
# #   #       #   # #   # #   
# ### ##### # # # # # ### ### 
#   # #   # #   #     # #   # 
### # # # # ########### ### # 
# # #   # #   #   #       #   
# # ##### ### # # # ##### ####
# #     # #   # # # #     #   
# ##### # # ### # ### ### # B 
#         #     #     #     # 
##############################
